15,maze-128-128-2
Grid:
128,128
@@@@@@@@@@@@@@@@@@@@@@@@@@@@@@@@@@@@@@@@@@@@@@@@@@@@@@@@@@@@@@@@@@@@@@@@@@@@@@@@@@@@@@@@@@@@@@@@@@@@@@@@@@@@@@@@@@@@@@@@@@@@@@@@
@................................@..............@....................@.................@........@...........@...................
@................................@..............@....................@.................@........@...........@...................
@..@@@@@@@@@@@@@@@@..@@@@@@@..@..@@@@..@..@@@@@@@..@@@@@@@..@@@@@@@..@@@@..@@@@@@@@@@@@@..@@@@..@@@@..@..@@@@..@@@@@@@@@@@@@@@@.
@..@........@.....@..@.....@..@........@..@.....@.....@.....@.....@........@...........@..@.....@.....@........@........@.......
@..@........@.....@..@.....@..@........@..@.....@.....@.....@.....@........@...........@..@.....@.....@........@........@.......
@..@..@..@@@@..@..@@@@..@..@..@..@@@@@@@@@@..@..@@@@..@..@@@@..@@@@@@@..@@@@..@@@@@@@..@..@..@@@@@@@..@@@@..@@@@@@@@@@..@..@@@@@
@.....@..@.....@........@..@..@..@...........@........@..@...........@..@.....@.....@.....@...........@..@..@........@..@.......
@.....@..@.....@........@..@..@..@...........@........@..@...........@..@.....@.....@.....@...........@..@..@........@..@.......
@@@@@@@..@..@@@@@@@@@@@@@..@..@..@..@@@@@@@@@@@@@@@@@@@..@@@@@@@@@@..@..@@@@..@..@..@@@@..@@@@@@@@@@@@@..@@@@..@@@@..@..@..@@@@.
@.....@..@........@...........@..@..@.....@........@.....@........@.....@.....@..@.....@..@........@..............@..@..@..@....
@.....@..@........@...........@..@..@.....@........@.....@........@.....@.....@..@.....@..@........@..............@..@..@..@....
@..@@@@..@..@@@@..@@@@@@@@@@@@@@@@..@..@..@@@@@@@..@@@@..@..@@@@@@@@@@@@@@@@..@..@..@@@@@@@@@@..@@@@..@@@@@@@@@@@@@..@..@..@..@.
@.....@..@..@..@.................@.....@...........@.....@..............@.....@..@.................@.....@.....@.....@.....@..@.
@.....@..@..@..@.................@.....@...........@.....@..............@.....@..@.................@.....@.....@.....@.....@..@.
@..@@@@..@@@@..@@@@@@@@@@@@@..@@@@@@@@@@..@@@@@@@@@@..@@@@@@@@@@@@@@@@..@..@@@@..@@@@@@@@@@..@@@@@@@@@@..@@@@..@..@@@@..@@@@..@.
@........@..............@..@.................@........@..............@.....@........@.....@...........@........@.....@..@.....@.
@........@..............@..@.................@........@..............@.....@........@.....@...........@........@.....@..@.....@.
@..@..@@@@..@@@@..@@@@@@@..@@@@@@@@@@@@@@@@@@@@@@..@..@..@..@@@@@@@@@@@@@@@@@@@@@@..@..@..@..@@@@..@@@@@@@..@@@@@@@..@@@@..@@@@.
@..@..@.....@..@...........@...........@........@..@..@..@.....@...........@........@..@..@.....@...........@........@........@.
@..@..@.....@..@...........@...........@........@..@..@..@.....@...........@........@..@..@.....@...........@........@........@.
@@@@..@@@@@@@..@@@@@@@..@..@..@@@@@@@@@@..@..@@@@..@@@@..@@@@..@..@@@@..@@@@@@@..@@@@..@..@@@@@@@@@@@@@@@@@@@..@@@@@@@@@@..@@@@@
@....................@..@..@..............@..@.....@.....@.....@.....@.....@........@..@.......................@.....@..........
@....................@..@..@..............@..@.....@.....@.....@.....@.....@........@..@.......................@.....@..........
@..@@@@@@@@@@@@@@@@..@..@..@@@@@@@@@@@@@@@@..@..@@@@..@@@@..@@@@..@@@@@@@..@@@@..@@@@..@@@@@@@@@@..@@@@@@@@@@@@@..@..@@@@@@@@@@.
@.....@...........@..@..@.................@..@.....@..@..@...........@...........@..@........@.....@..............@..@..........
@.....@...........@..@..@.................@..@.....@..@..@...........@...........@..@........@.....@..............@..@..........
@@@@@@@..@@@@@@@..@..@..@@@@@@@..@@@@@@@..@..@@@@..@..@..@..@@@@@@@@@@..@@@@@@@@@@..@@@@@@@..@@@@@@@..@@@@@@@@@@@@@..@..@@@@@@@@
@.....@..@.....@..@..@........@..@..@...........@........@.....@.....@.....@..........................@........@..@..@..@.......
@.....@..@.....@..@..@........@..@..@...........@........@.....@.....@.....@..........................@........@..@..@..@.......
@..@@@@..@..@@@@..@..@@@@@@@..@@@@..@@@@@@@@@@@@@@@@@@@@@@@@@..@..@..@..@@@@..@@@@@@@@@@@@@@@@@@@@@@@@@..@..@..@..@..@..@..@@@@.
@.....@.....@.....@.....@.....@..........................@.....@..@.....@.....@........@..............@..@..@.....@..@........@.
@.....@.....@.....@.....@.....@..........................@.....@..@.....@.....@........@..............@..@..@.....@..@........@.
@@@@..@@@@..@..@@@@@@@..@@@@..@..@@@@@@@@@@@@@@@@@@@@@@..@..@..@@@@@@@@@@..@@@@..@..@@@@@@@..@@@@@@@..@@@@..@@@@@@@..@..@@@@@@@.
@.....@.....@..@.....@........@........@.....@..@.....@.....@........@.....@.....@...........@.....@........@........@..@.......
@.....@.....@..@.....@........@........@.....@..@.....@.....@........@.....@.....@...........@.....@........@........@..@.......
@@@@..@..@@@@..@@@@..@..@..@..@@@@@@@..@..@..@..@..@@@@@@@@@@@@@@@@@@@..@@@@..@@@@@@@@@@@@@@@@@@@..@@@@..@@@@..@@@@@@@@@@..@..@@
@.....@..@........@..@..@..@..@..@.....@..@..@...........@........@.....@........@....................@..@...........@..@..@....
@.....@..@........@..@..@..@..@..@.....@..@..@...........@........@.....@........@....................@..@...........@..@..@....
@..@@@@..@..@@@@@@@..@@@@@@@..@..@@@@..@..@..@..@@@@@@@..@..@@@@..@..@@@@@@@@@@..@..@@@@@@@@@@@@@..@@@@..@@@@@@@@@@..@..@..@..@@
@........@........@.................@..@..@........@.....@..@..@.....@...........@.....@..............@.....@.....@..@.....@..@.
@........@........@.................@..@..@........@.....@..@..@.....@...........@.....@..............@.....@.....@..@.....@..@.
@..@@@@@@@@@@..@@@@@@@@@@@@@@@@@@@@@@..@..@@@@@@@@@@..@@@@..@..@@@@..@@@@..@@@@@@@@@@@@@..@..@@@@@@@@@@..@@@@..@..@..@..@@@@@@@.
@..@........@.......................@..@..@.....@.....@.....@.....@..@.....@...........@..@..@...........@.....@..@........@....
@..@........@.......................@..@..@.....@.....@.....@.....@..@.....@...........@..@..@...........@.....@..@........@....
@..@@@@..@@@@@@@@@@@@@@@@@@@@@@@@@..@..@..@..@..@..@..@..@@@@..@@@@..@..@@@@..@@@@..@@@@..@@@@@@@@@@@@@@@@..@@@@..@@@@@@@..@..@.
@.....@..@.......................@.....@.....@..@..@..@..@...........@........@.....@.....@.................@.....@........@..@.
@.....@..@.......................@.....@.....@..@..@..@..@...........@........@.....@.....@.................@.....@........@..@.
@@@@..@..@..@@@@@@@@@@@@@@@@@@@..@@@@@@@@@@..@@@@..@..@..@@@@@@@@@@..@@@@@@@..@..@..@@@@..@..@@@@@@@@@@@@@@@@..@@@@..@..@@@@..@@
@..@.....@.................@..@........@.....@.....@..@...........@........@..@..@.....@..@.................@..@.....@.....@....
@..@.....@.................@..@........@.....@.....@..@...........@........@..@..@.....@..@.................@..@.....@.....@....
@..@@@@..@@@@@@@@@@@@@@@@..@..@@@@..@@@@@@@@@@..@..@..@@@@@@@@@@..@@@@@@@..@@@@..@@@@..@..@@@@@@@@@@@@@@@@..@..@..@@@@@@@@@@@@@.
@.....@.....@..@.....@.....@.....@..............@..@........@.....@.....@........@........@.................@..@.....@..........
@.....@.....@..@.....@.....@.....@..............@..@........@.....@.....@........@........@.................@..@.....@..........
@..@..@..@@@@..@..@..@..@@@@..@@@@..@@@@@@@@@@@@@..@@@@@@@@@@..@@@@..@@@@@@@@@@@@@..@@@@@@@..@@@@@@@@@@@@@@@@..@@@@@@@..@@@@@@@@
@..@..@.....@.....@..@..@...........@.....@.....@..............@.................@..@..@...........@........@...........@.....@.
@..@..@.....@.....@..@..@...........@.....@.....@..............@.................@..@..@...........@........@...........@.....@.
@..@@@@@@@..@..@..@..@..@..@@@@@@@@@@..@..@..@@@@@@@@@@@@@@@@..@@@@@@@..@@@@@@@..@@@@..@@@@@@@@@@..@..@@@@..@@@@@@@@@@@@@..@..@.
@........@.....@..@..@..@...........@..@..@..............@........@.....@.................@........@..@....................@....
@........@.....@..@..@..@...........@..@..@..............@........@.....@.................@........@..@....................@....
@@@@..@@@@@@@@@@..@..@..@@@@@@@..@@@@..@..@@@@@@@..@@@@..@@@@@@@@@@..@@@@@@@..@@@@@@@@@@@@@..@@@@..@..@..@@@@@@@@@@@@@@@@@@@..@.
@.....@...........@..@.....@.....@.....@...........@.....@........@........@.....@...........@.....@..@..............@..@..@..@.
@.....@...........@..@.....@.....@.....@...........@.....@........@........@.....@...........@.....@..@..............@..@..@..@.
@..@@@@..@@@@@@@@@@@@@@@@..@@@@@@@..@@@@..@@@@@@@@@@@@@..@..@@@@..@@@@..@@@@..@@@@..@@@@@@@@@@@@@..@..@@@@@@@@@@@@@..@..@..@@@@.
@........@..............@........@..@..@..@...........@........@........@.....@...........@..@.....@...........@.....@........@.
@........@..............@........@..@..@..@...........@........@........@.....@...........@..@.....@...........@.....@........@.
@..@@@@@@@..@@@@@@@@@@@@@@@@..@..@..@..@..@..@@@@@@@..@..@@@@..@@@@@@@@@@..@..@@@@@@@@@@..@..@..@@@@..@@@@@@@@@@..@@@@@@@@@@..@.
@..@.......................@..@........@..@..@.....@..@..@..@..@...........@.....@.....@..@........@..@...........@...........@.
@..@.......................@..@........@..@..@.....@..@..@..@..@...........@.....@.....@..@........@..@...........@...........@.
@..@@@@@@@@@@@@@@@@@@@..@..@@@@@@@@@@@@@..@..@@@@..@..@..@..@..@..@@@@@@@@@@@@@@@@..@..@..@..@@@@..@@@@..@@@@@@@@@@..@@@@@@@@@@.
@..@........@...........@..@..............@........@..@.....@..@.................@..@..@..@.....@.....@.....@...................
@..@........@...........@..@..............@........@..@.....@..@.................@..@..@..@.....@.....@.....@...................
@..@..@..@..@..@@@@@@@@@@..@..@@@@@@@@@@@@@..@..@@@@..@@@@..@..@@@@..@@@@@@@@@@@@@..@..@..@@@@@@@@@@..@..@..@..@@@@@@@@@@@@@@@@@
@.....@..@..@...........@..@..@.....@.....@..@..@...........@..@..@.....@...........@.....@.....@.....@..@..@.....@.............
@.....@..@..@...........@..@..@.....@.....@..@..@...........@..@..@.....@...........@.....@.....@.....@..@..@.....@.............
@@@@@@@@@@..@..@@@@@@@..@..@..@..@..@@@@..@@@@@@@@@@@@@@@@@@@..@..@..@@@@..@@@@@@@@@@@@@@@@..@..@..@@@@@@@..@@@@..@..@@@@..@@@@@
@...........@..@........@..@.....@.....@...........@........@..@.....@..@..@........@.....@..@.....@...........@..@.....@.....@.
@...........@..@........@..@.....@.....@...........@........@..@.....@..@..@........@.....@..@.....@...........@..@.....@.....@.
@@@@..@@@@@@@@@@..@@@@@@@..@@@@@@@..@@@@@@@@@@@@@..@..@..@@@@..@@@@@@@..@..@@@@..@..@..@..@..@@@@@@@..@..@@@@@@@..@@@@..@..@@@@.
@..@.....@........@.....@..@...........@...........@..@.....@..@........@..@.....@..@..@..@...........@..@...........@..@.......
@..@.....@........@.....@..@...........@...........@..@.....@..@........@..@.....@..@..@..@...........@..@...........@..@.......
@..@..@@@@..@@@@@@@@@@..@@@@@@@..@@@@@@@..@@@@@@@@@@..@@@@..@..@..@@@@..@..@..@@@@..@@@@..@@@@@@@..@@@@@@@..@@@@@@@@@@..@@@@@@@.
@..@..@...........@...........@.....@..............@.....@..@..@.....@..@..@..@...........@.....@..@.....@..............@.....@.
@..@..@...........@...........@.....@..............@.....@..@..@.....@..@..@..@...........@.....@..@.....@..............@.....@.
@..@..@..@@@@@@@..@..@@@@@@@@@@..@@@@@@@@@@@@@..@..@@@@@@@..@..@..@@@@..@..@..@@@@..@@@@@@@..@..@@@@..@@@@@@@@@@@@@@@@@@@..@@@@.
@..@..@.....@..@..@...........@..@...........@..@...........@.....@.....@..@..@.....@.....@..@..............@........@........@.
@..@..@.....@..@..@...........@..@...........@..@...........@.....@.....@..@..@.....@.....@..@..............@........@........@.
@..@..@@@@..@..@..@@@@@@@@@@..@..@..@..@@@@..@@@@@@@..@@@@..@@@@@@@..@@@@..@..@@@@@@@..@..@..@@@@..@@@@@@@..@@@@..@@@@@@@..@..@.
@........@..@..@..............@..@..@.....@..@........@..@........@........@...........@........@.....@.....@...........@..@....
@........@..@..@..............@..@..@.....@..@........@..@........@........@...........@........@.....@.....@...........@..@....
@..@@@@..@..@..@@@@@@@@@@..@..@..@@@@@@@..@..@@@@@@@..@..@..@@@@..@..@@@@@@@..@@@@@@@@@@@@@@@@@@@@@@@@@..@@@@@@@@@@..@@@@@@@..@@
@..@.....@..@.....@.....@..@..@.....@..@..@........@.....@..@.....@..@.....@.....@..............@........@........@........@..@.
@..@.....@..@.....@.....@..@..@.....@..@..@........@.....@..@.....@..@.....@.....@..............@........@........@........@..@.
@@@@..@@@@..@@@@..@..@..@..@@@@..@..@..@..@@@@@@@..@@@@@@@..@..@@@@@@@@@@..@@@@..@@@@..@..@@@@@@@..@@@@@@@..@@@@..@@@@..@..@..@.
@..@..@........@..@..@.....@.....@..@.....@.....@..@..@.....@..@..............@........@.....@.....@...........@.....@..@.....@.
@..@..@........@..@..@.....@.....@..@.....@.....@..@..@.....@..@..............@........@.....@.....@...........@.....@..@.....@.
@..@..@@@@@@@..@..@..@@@@..@..@@@@..@@@@..@..@..@..@..@..@@@@@@@..@@@@@@@@@@..@@@@..@@@@@@@@@@@@@..@@@@..@@@@@@@@@@@@@..@@@@..@.
@..@.....@..@..@..@..@.....@..@...........@..@..@..@........@.....@........@...........@.....@.....@.....@.................@..@.
@..@.....@..@..@..@..@.....@..@...........@..@..@..@........@.....@........@...........@.....@.....@.....@.................@..@.
@..@@@@..@..@..@..@..@@@@..@..@@@@..@@@@@@@..@..@..@@@@@@@..@@@@..@@@@@@@..@..@@@@@@@@@@..@..@..@@@@..@@@@..@@@@@@@@@@@@@@@@..@.
@.....@..@........@.....@..@.....@..@.....@..@..@.....@........@...........@..@...........@.....@.................@........@..@.
@.....@..@........@.....@..@.....@..@.....@..@..@.....@........@...........@..@...........@.....@.................@........@..@.
@@@@..@..@@@@@@@..@@@@..@..@..@..@@@@..@..@..@..@@@@..@@@@..@@@@@@@@@@@@@..@@@@..@@@@..@@@@@@@@@@@@@@@@@@@@@@@@@@@@..@@@@..@..@.
@.....@........@..@.....@..@..@.....@..@.....@.....@..@..@.....@........@..@.....@.....@....................@........@.....@..@.
@.....@........@..@.....@..@..@.....@..@.....@.....@..@..@.....@........@..@.....@.....@....................@........@.....@..@.
@..@@@@@@@@@@..@@@@..@@@@..@..@..@..@..@@@@@@@..@@@@..@..@@@@..@..@..@@@@..@@@@..@..@@@@..@@@@@@@@@@@@@@@@..@..@@@@@@@@@@..@..@.
@.......................@..@..@..@..@..@..@........@..@........@..@.....@.....@..@.....@..@.....@........@.....@...........@....
@.......................@..@..@..@..@..@..@........@..@........@..@.....@.....@..@.....@..@.....@........@.....@...........@....
@..@@@@@@@@@@@@@@@@@@@@@@@@@..@@@@..@..@..@..@..@..@..@..@@@@..@..@@@@..@@@@..@..@@@@..@..@..@..@..@@@@..@@@@@@@..@@@@@@@@@@..@@
@........@.................@..@.....@.....@..@..@..@.....@.....@..@..@........@.....@..@.....@..@.....@........@...........@..@.
@........@.................@..@.....@.....@..@..@..@.....@.....@..@..@........@.....@..@.....@..@.....@........@...........@..@.
@@@@@@@@@@..@@@@..@@@@..@..@..@@@@..@..@@@@..@@@@..@@@@@@@@@@@@@..@..@@@@@@@@@@@@@..@@@@@@@@@@..@@@@@@@..@@@@..@@@@@@@@@@..@..@.
@...........@.....@.....@.....@..@..@..@.....@..@.....@..@........@..............@...........@...........@.....@.....@..@..@....
@...........@.....@.....@.....@..@..@..@.....@..@.....@..@........@..............@...........@...........@.....@.....@..@..@....
@..@@@@@@@@@@..@@@@@@@@@@@@@@@@..@..@@@@..@@@@..@@@@..@..@..@@@@..@..@@@@@@@@@@@@@..@@@@@@@..@@@@@@@@@@@@@..@@@@..@..@..@..@..@@
@.....@.....@..@........@...........@..@.....@...........@..@........@........@.....@.....@...........@..@.....@..@.....@.....@.
@.....@.....@..@........@...........@..@.....@...........@..@........@........@.....@.....@...........@..@.....@..@.....@.....@.
@..@@@@..@@@@..@@@@..@..@@@@@@@@@@@@@..@@@@..@@@@@@@@@@..@..@@@@@@@@@@..@@@@..@@@@..@..@@@@@@@..@@@@..@..@@@@..@..@@@@..@@@@..@.
@..@.....@...........@..@.....@...........@...........@..@...........@..@........@.....@...........@........@.....@........@....
@..@.....@...........@..@.....@...........@...........@..@...........@..@........@.....@...........@........@.....@........@....
@..@@@@..@..@@@@@@@@@@..@..@..@..@@@@..@@@@@@@@@@@@@..@..@..@@@@@@@..@@@@..@..@@@@@@@@@@@@@@@@@@@..@@@@@@@@@@..@@@@..@@@@@@@@@@.
@.....@.....@.....@.....@..@.....@..@..@.....@..@.....@..@..@.....@.....@..@..@..@..@..@...........@..............@...........@.
@.....@.....@.....@.....@..@.....@..@..@.....@..@.....@..@..@.....@.....@..@..@..@..@..@...........@..............@...........@.
@..@@@@@@@@@@@@@..@..@@@@..@@@@@@@..@..@..@..@..@..@..@@@@@@@..@..@..@@@@..@@@@..@..@..@@@@..@@@@@@@..@@@@@@@@@@..@@@@..@@@@@@@@
@..@.....@..@..@........@.....@........@..@..@.....@...........@..@..@....................@........@..@........@.....@..@.....@.
@..@.....@..@..@........@.....@........@..@..@.....@...........@..@..@....................@........@..@........@.....@..@.....@.
@..@..@..@..@..@@@@@@@..@@@@..@@@@@@@..@..@..@@@@@@@@@@@@@@@@@@@..@..@@@@@@@@@@@@@@@@@@@..@@@@@@@..@..@@@@..@@@@..@@@@..@..@@@@.
@.....@..@.......................@........@.......................@.............................@........@...........@..........
Agents:
7
0,64,19
1,7,74
2,122,98
3,102,23
4,82,77
5,65,1
6,31,27
