45,arena
Grid:
49,49
@@@@@@@@@@@@@@@@@@@@@@@@@@@@@@@@@@@@@@@@@@@@@@@@@
@@@............@@@@.@@@...@@@@.@@@@............@@
@@.............@@@........@@@..@@@.............@@
@...............................................@
@...............................................@
@...............................................@
@...............................................@
@.......................@@......................@
@......................@@@......................@
@......................@@@......................@
@...............................................@
@...............................................@
@...............................................@
@...............................................@
@...............................................@
@@@............@@@@............@@@@............@@
@@@............@@@@............@@@@............@@
@@@............@@@@............@@@@............@@
@@.............@@@.............@@@.............@@
@@..............................................@
@@..............................................@
@@..............................................@
@@..............................................@
@...............................................@
@...............................................@
@...............................................@
@@..............................................@
@@@.............................................@
@@@.............................................@
@@@.............................................@
@...............................................@
@@@............@@@@............@@@@............@@
@@@............@@@@............@@@@............@@
@@@............@@@@............@@@@............@@
@@.............@@@.............@@@.............@@
@...............................................@
@...............................................@
@...............................................@
@...............................................@
@...............................................@
@...............................................@
@...............................................@
@...............................................@
@...............................................@
@...............................................@
@...............................................@
@...................@@@...@@@...................@
@@@............@@@@.@@@@..@@@@.@@@@............@@
@@@@@@@@@@@@@@@@@@@@@@@@@@@@@@@@@@@@@@@@@@@@@@@@@
Agents:
13
0,28,29
1,12,36
2,36,27
3,23,17
4,28,16
5,30,9
6,16,27
7,4,11
8,39,22
9,43,30
10,14,23
11,2,4
12,21,25
