29,arena
Grid:
49,49
@@@@@@@@@@@@@@@@@@@@@@@@@@@@@@@@@@@@@@@@@@@@@@@@@
@@@............@@@@.@@@...@@@@.@@@@............@@
@@.............@@@........@@@..@@@.............@@
@...............................................@
@...............................................@
@...............................................@
@...............................................@
@.......................@@......................@
@......................@@@......................@
@......................@@@......................@
@...............................................@
@...............................................@
@...............................................@
@...............................................@
@...............................................@
@@@............@@@@............@@@@............@@
@@@............@@@@............@@@@............@@
@@@............@@@@............@@@@............@@
@@.............@@@.............@@@.............@@
@@..............................................@
@@..............................................@
@@..............................................@
@@..............................................@
@...............................................@
@...............................................@
@...............................................@
@@..............................................@
@@@.............................................@
@@@.............................................@
@@@.............................................@
@...............................................@
@@@............@@@@............@@@@............@@
@@@............@@@@............@@@@............@@
@@@............@@@@............@@@@............@@
@@.............@@@.............@@@.............@@
@...............................................@
@...............................................@
@...............................................@
@...............................................@
@...............................................@
@...............................................@
@...............................................@
@...............................................@
@...............................................@
@...............................................@
@...............................................@
@...................@@@...@@@...................@
@@@............@@@@.@@@@..@@@@.@@@@............@@
@@@@@@@@@@@@@@@@@@@@@@@@@@@@@@@@@@@@@@@@@@@@@@@@@
Agents:
13
0,29,3
1,7,35
2,28,31
3,41,14
4,19,24
5,46,1
6,38,24
7,35,31
8,8,7
9,17,40
10,19,9
11,2,13
12,39,2
