15,arena
Grid:
49,49
@@@@@@@@@@@@@@@@@@@@@@@@@@@@@@@@@@@@@@@@@@@@@@@@@
@@@............@@@@.@@@...@@@@.@@@@............@@
@@.............@@@........@@@..@@@.............@@
@...............................................@
@...............................................@
@...............................................@
@...............................................@
@.......................@@......................@
@......................@@@......................@
@......................@@@......................@
@...............................................@
@...............................................@
@...............................................@
@...............................................@
@...............................................@
@@@............@@@@............@@@@............@@
@@@............@@@@............@@@@............@@
@@@............@@@@............@@@@............@@
@@.............@@@.............@@@.............@@
@@..............................................@
@@..............................................@
@@..............................................@
@@..............................................@
@...............................................@
@...............................................@
@...............................................@
@@..............................................@
@@@.............................................@
@@@.............................................@
@@@.............................................@
@...............................................@
@@@............@@@@............@@@@............@@
@@@............@@@@............@@@@............@@
@@@............@@@@............@@@@............@@
@@.............@@@.............@@@.............@@
@...............................................@
@...............................................@
@...............................................@
@...............................................@
@...............................................@
@...............................................@
@...............................................@
@...............................................@
@...............................................@
@...............................................@
@...............................................@
@...................@@@...@@@...................@
@@@............@@@@.@@@@..@@@@.@@@@............@@
@@@@@@@@@@@@@@@@@@@@@@@@@@@@@@@@@@@@@@@@@@@@@@@@@
Agents:
15
0,45,2
1,1,44
2,17,46
3,13,7
4,46,36
5,13,17
6,44,33
7,18,22
8,7,39
9,42,40
10,6,29
11,36,35
12,10,1
13,15,20
14,7,26
