19,arena
Grid:
49,49
@@@@@@@@@@@@@@@@@@@@@@@@@@@@@@@@@@@@@@@@@@@@@@@@@
@@@............@@@@.@@@...@@@@.@@@@............@@
@@.............@@@........@@@..@@@.............@@
@...............................................@
@...............................................@
@...............................................@
@...............................................@
@.......................@@......................@
@......................@@@......................@
@......................@@@......................@
@...............................................@
@...............................................@
@...............................................@
@...............................................@
@...............................................@
@@@............@@@@............@@@@............@@
@@@............@@@@............@@@@............@@
@@@............@@@@............@@@@............@@
@@.............@@@.............@@@.............@@
@@..............................................@
@@..............................................@
@@..............................................@
@@..............................................@
@...............................................@
@...............................................@
@...............................................@
@@..............................................@
@@@.............................................@
@@@.............................................@
@@@.............................................@
@...............................................@
@@@............@@@@............@@@@............@@
@@@............@@@@............@@@@............@@
@@@............@@@@............@@@@............@@
@@.............@@@.............@@@.............@@
@...............................................@
@...............................................@
@...............................................@
@...............................................@
@...............................................@
@...............................................@
@...............................................@
@...............................................@
@...............................................@
@...............................................@
@...............................................@
@...................@@@...@@@...................@
@@@............@@@@.@@@@..@@@@.@@@@............@@
@@@@@@@@@@@@@@@@@@@@@@@@@@@@@@@@@@@@@@@@@@@@@@@@@
Agents:
15
0,39,38
1,36,6
2,44,33
3,2,23
4,8,47
5,40,43
6,27,31
7,11,16
8,16,6
9,29,38
10,13,3
11,23,11
12,33,3
13,26,41
14,7,10
