1,arena
Grid:
49,49
@@@@@@@@@@@@@@@@@@@@@@@@@@@@@@@@@@@@@@@@@@@@@@@@@
@@@............@@@@.@@@...@@@@.@@@@............@@
@@.............@@@........@@@..@@@.............@@
@...............................................@
@...............................................@
@...............................................@
@...............................................@
@.......................@@......................@
@......................@@@......................@
@......................@@@......................@
@...............................................@
@...............................................@
@...............................................@
@...............................................@
@...............................................@
@@@............@@@@............@@@@............@@
@@@............@@@@............@@@@............@@
@@@............@@@@............@@@@............@@
@@.............@@@.............@@@.............@@
@@..............................................@
@@..............................................@
@@..............................................@
@@..............................................@
@...............................................@
@...............................................@
@...............................................@
@@..............................................@
@@@.............................................@
@@@.............................................@
@@@.............................................@
@...............................................@
@@@............@@@@............@@@@............@@
@@@............@@@@............@@@@............@@
@@@............@@@@............@@@@............@@
@@.............@@@.............@@@.............@@
@...............................................@
@...............................................@
@...............................................@
@...............................................@
@...............................................@
@...............................................@
@...............................................@
@...............................................@
@...............................................@
@...............................................@
@...............................................@
@...................@@@...@@@...................@
@@@............@@@@.@@@@..@@@@.@@@@............@@
@@@@@@@@@@@@@@@@@@@@@@@@@@@@@@@@@@@@@@@@@@@@@@@@@
Agents:
13
0,8,29
1,9,29
2,43,47
3,19,43
4,19,9
5,13,36
6,30,46
7,25,24
8,8,3
9,11,31
10,44,6
11,31,10
12,7,16
